+-+-+-+-+-+-+-+
|b|   | | |   |
+ +-+ + + +-+ +
|   |   |  F  |
+-+ + +-+ +-+ +
|F|   |  F  | |
+ + +-+ +-+-+ +
|       |     |
+-+ + +-+-+ +-+
|F    FF     c|
+-+-+-+-+-+-+-+